Оглавление : Содержание (içerik)
Эпоха : Период, эра
Чудо : Прелесть (mucize)
Спелый : Зрелый (olgun)
Очевидец : Свидетель (görgü tanığı)
Навестить : Проведать
Произойти : Случиться
щадить : acımak, merhamet etmek
Оглянуться : Обернуться (geriye bakmak)
Чародей : Волшебник (büyücü)
Изображать : Показывать (tasvir etmek, betimlemek)
Популярность : Известность
Государь : Царь (Majesti!, Efendim!)
Хлебосольный : Гостеприимный
Лакей : Слуга (uşak)
Разрешать : Позволять
Остерегаться : Опасаться (sakınmak)
Искоренить : Уничтожить
Похитить : Украсть (çalmak)
Отпирать : Открыть
Запирать : Закрывать
Бодрствовать : Не спать (uyanık kalmak)
Пища : Еда
Откровенно : Открыто
Предугадать : Предвидеть (bilmek, tahmin etmek)
Творец : Создатель
Отвинтить : Открутить (sökmek, gevşetmek)
Наклониться : Нагибаться (eğilmek)
Благополучно : Хорошо (sağ salim)
Перебинтовать : Перевязать (tekrar sarmak/bantlamak)
Меткий : Точный (isabetli)
Упрек : Укор (sitem)
Слишком : Чересчур
Шиш : Фига (hiçbir şey)
Веснушки : Пятнышки (çiller)
Инопланетянин : Пришелец (uzaylı)
Хмурый : Мрачный (somurtkan)
Обнаженный : Голый (çıplak)
Предел : Граница (sınır, uç)
Шофер : Водитель
Озабочен : Обеспокоен (kaygılı)
Крутить : Вертеть (döndürmek)
Крутиться : Вращаться (dönmek)
Погасить : Потушить (söndürmek (ışık, ateş))
Заурядный : Обыкновенный
Банкнота : Купюра
Башмак : Туфля
Взобраться : Залезть (tırmanmak)
Статный : Стройный (düzgün, biçimli)
Трость : Палочка (baston)
Новобрачные : Молодожены (yeni evliler)
Сиять : Светить
