автомат - Otomat, makine
проанализировать - analiz etmek
ансамбль - Topluluk
ангина - Boğaz ağrısı
аспирант/аспирантка - Yüksek lisans öğrencisi
аспирантура - Yüksek lisans
аудитория - Sınıf
афиша - Afiş
бандероль - Paket
банка - Kavanoz
батон - Somun ekmek
беречь/сберечь - Saklamak/Korumak
беспокоиться - to worry
бланк - Boş
бледный - Soluk (renk)
ближе - closer
борода - Sakal
бороться - Savaşmak
борьба - mücadele
булочка - Çörek
булочная - Fırın
бывший - ex... (is, es vs.)
вверху - Yukarıda
вежливый - Kibar
велик - Büyük
верхний - Üst
вести себя - Hareket etmek
власть - Power, authority
вниз - Aşağı
внизу - Altında
внутри - İçinde
вовремя - Zamanında
воевать - Savaşmak
воздух - Hava
вокзал - Tren İstasyonu
воспитание - Eğitim
воспитывать - Yetiştirmek
впервые - For the first time
вслух - Yüksek sesle
вчерашний - Dünkü
вызывать / вызвать - Çağırmak
выражать - İfade etmek
высший - En yüksek
параша - Bok kabı
потише - Daha sessiz!
неудивительно - Şaşırtıcı değil, doğal olarak
представить - Sunmak, tanıtmak
замечательный - Göze çarpan, dikkate değer
ненадежный - Güvenilmez
разочарованный - Hayal kırıklığına uğramış
несомненно - Belliki, şüphesiz
ясный - Açık, belirgin
странный - Tuhaf
так оно и есть - Bu işler böyle
особенно - Özellikle
анекдот - Fıkra
развлекательный - Eğlenceli
удивленный - Şaşırtıcı
инфаркт - Kalp krizi
это ниже твоего достоинства - Bu sana yakışmadı
предполагать - Düşünmek, fikir yürütmek
великие умы думают одинаково - Aklın yolu bir
один в поле не воин - Bir elin nesi var iki elin sesi var
мудрый - Akıllıca
предположить - Sanmak
цена - Bedel
благо - Fayda, iyilik
избегать - Kaçınmak
ограбление - Soygun
копейка рубль бережёт - Damlaya damlaya göl olur
процедура - Prosedür, işlem
отлежаться - Dinlenmek (hastanın)
доказательство - Kanıt
доказывать - Göstermek
любой ценой - Bedeli ne olursa olsun
алиби - Mazeret
население - Nüfus
фонд - Ödenek
влиятельный - Güçlü, kuvvetli
в это время - Bu zamanda, bu esnada
в эти дни - Bugünlerde
в последнее время - Son zamanlarda
чёткий / ровный - Good
угарный - Смешной
от души - СПАСИБО
по-братски / не в падлу - ПОЖАЛУЙСТА
жрать охота - Я ПРОГОЛОДАЛСЯ
чё как сам ваще - КАК ДЕЛА
развивать навыки - Becerileri geliştirmek
разбираться - Bir işten anlamak
отличаться - Farklı olmak (он мало чем отличается от тебя)
застенчивый - Utangaç
один умножить на ноль равно ноль - One times zero equals zero
чётные и нечётные - Even and odd
круг - Daire
квадрат - Kare
баранина - Koyun / kuzu eti
индейка - Hindi
зелень - Sebze
капуста - Lahana
свёкла - Pancar
баклажан - Patlıcan
чеснок - Sarımsak
шпинат - Ispanak
ягоды - Yemiş
дыня - Kavun
персик - Şeftali
абрикос - Kayısı
клубника - Çilek
какая картинка! - What a picture
кнопка - Tuş, buton
во время... (-in hali) - during...
переплатить - to overpay
выспаться - Uykusunu almak
проспать - Uyuya kalmak
раздумать - Vazgeçmek, fikir değiştirmek
жесть - Crazy
ржака - Really funny
дерьмо - Shit
мудак - Asshole
ублюдок - Bastard
хуйня - Bullshit
осёл - Jackass
пизда - Cunt
писка - Pussy
говно - Crap
урод - Ucube
вверху - Yukarıda
внизу - Aşağıda
впереди - Önde
сзади - Arkada
слева - Solda
справа - Sağда
вверх - Yukarıya
вниз - Aşağıya
вперёд - İleriye/öne
назад - Geriye/arkaya
налево - Sola
направо - Sağa
верхний - Üst/üstteki
нижний - Alt/alttaki
позже - Sonra
прикиньте - Düşünsenize
перед... - ...-den, -dan önce
борода - Sakal
усы - Bıyık
подобные - Benzer, bu tarz
крутиться на языке - Dilimin ucunda
балдеж - Классно, круто
не только... но... - Sadece değil... de de öyle
положи руки в карман - Ellerini cebine koy
а ты кем устраиваешься? - Mesleğin ne?
при... (-e hali) - ...sırasında
мероприятие - Etkinlik
вести себя - Davranmak
нам нечего терять/говорить - Kaybedecek / söyleyecek bir şeyimiz yok
о том - Поговорим о том, какие страны...
легко запутаться - Kafan kolayca karışabilir
в течение... - Süresince, boyunca
перед тем как - Başlamadan önce
в общем - Kısaca, özetle
в наши дни - Günümüzde
жаловаться - Şikayet etmek
анализировать - analiz etmek
беседовать - Sohbet etmek
бить - Vurmak, dövmek
бороться - Savaşmak (борюсь, боремся...)
бриться - Sakal tıraşı olmak (бреюсь, ...)
бросать - atmak
бывать - olmak
воспитывать - eğitmek, yetiştirmek
воевать - Savaşmak
возражать - itiraz etmek
выбивать - Kırmak
вызывать - Çağırmak, neden olmak
выполнять - Yerine getirmek, gerçekleştirmek
выражать - ifade etmek
грустить - hüzünlenmek
добавить - eklemek
доказать - Kanıtlamak, ispat etmek
допустим - düşünelim ki, varsayalım
ебануть - s*kmek
забрать - almak
заважничать - hava atmak
заваливать - Yığmak, (sınavda) çuvallamak
зависеть - bağlantılı olmak
замедлять - yavaşlamak
занять - Meşgul olmak
конвертировать - dönüştürmek
леденеть - donmak
лидерствовать - liderlik yapmak
манить - işaret vererek çağırmak
надоедать - bıkmak, usanmak
намекать - ima etmek, çıtlatmak
обижаться - darılmak / kırılmak
обмануть / обманывать - aldatmak
обозначать - başkasına benzetmek
одобрять - takdir etmek
организовать - organize etmek
останавливать / остановить - durdurmak
отвыкать - alışkanlıktan vazgeçmek
отказывать / отказать - reddetmek
отпускать / отпустить - salmak, salıvermek
отражать - yansımak, yansıtmak
охладеть - birinden, bir şeyden soğumak
ошибаться - hata yapmak, yanılmak
переместить - yerini değiştirmek
побеждать / победить - galip gelmek
поддерживать - desteklemek
подозревать - şüphelenmek
подтверждать - doğrulamak, teyit etmek
позволить - izin vermek
покарать - cezalandırmak
покорять - fethetmek
посещать - ziyaret etmek
посоветовать - tavsiye bulunmak
потешить - eğlendirmek
практиковать - pratik yapmak
предлагать - önermek, teklif etmek
представить - sunmak, tanıtmak
прибывать / прибыть - gelmek, varmak
привыкать - alışmak
принадлежать - ait olmak, birinin malı olmak
приобрести - satın almak
приставать - musallat olmak, yapışmak
приучать - alıştırmak, eğitmek
производить - üretmek
проснуться - uyanmak
прыгать / прыгнуть - zıplamak
увеличивать / увеличить - arttırmak
угащивать - ısrarla ikram etmek
уговорить - razı etmek
угрожать - tehdit etmek
ударить - vurmak
умолять - yalvarmak
уничтожить - yok etmek
упадать - düşmek
упоминать - anmak
управлять - yönetmek
ускорять - hızlandırmak
уснуть - uyumak
устраивать - kurmak
уточнить - netleştirmek, kesinleştirmek
ухудшать - kötüleştirmek
финансировать - finanse etmek
фотографировать - fotoğraf çekilmek
хваливать - övmek
чихать - hapşırmak, öksürmek
разбивать - kırmak, mahvetmek
разбудить - Uyandırmak
разделять - bölmek
разрушать - yıkmak, mahvetmek
распускать - azat etmek
рассмотреть - gözden geçirmek, incelemek
расстаться - ayrılmak
расчувствоваться - Duygulanmak
реализовать - gerçekleştirmek
связать - ilişkili / bağlantılı olmak
скачать - indirmek, yükлеmek
следовать - takip etmek
соблюдать - uymak
сокращать - azaltmak
сомневаться - şüphelenmek
сообщать - bildirmek
суметь - yapabilmek, yapmasını bilmek
соскучиться - özlemek
состояться - yapılmak
спорить - tartışmak, münakaşa etmek
справиться - üstesinden gelmek
строить - inşa etmek
тренироваться - antrenman yapmak
торговаться - pazarlık etmek
